Level|Number of boss lives|Number of items|Number of bots appearing|Number of bots on screen|Number of target bots
Lv|Nobl|Noi|Noba1|Nobos1|Notb1|Noba2|Nobos2|Notb2|Noba3|Nobos3|Notb3
01|0020|003|00002|000010|00015|00001|000005|00010|00000|000002|00005
02|0015|003|00002|000020|00060|00000|000000|00000|00000|000000|00000
03|0015|003|00000|000000|00000|00001|000005|00010|00000|000000|00000
04|0015|002|00002|000020|00060|00000|000000|00000|00000|000000|00000
05|0015|002|00002|000020|00060|00000|000000|00000|00000|000000|00000
06|0020|002|00002|000030|00060|00000|000000|00000|00000|000000|00000
07|0020|003|00000|000010|00099|00000|000010|00099|00000|000010|00099